P---------------------------O
xxxx----------------------xxx
-----------E-----------------
------------------E----------
----xxx---------------xxx----
-----------------------------
-----------------------------
--------xxxxxxxxxx-----------