P---------------------------O
xxxxx--------E-----------xxxx
---x------x-x-x-x---------x--
---x----------------------x--
---x----------------------x--
-----------------------------
-----------------------------
--------xxxxxxxxxx-----------